############
#          #
#     *    #
#  \\\\\\  #
#          #
#  \\\\\\\ #
#  \       #
#  \       #
#        * #
#  ### ### #
#   R#\#\\ #
######L#####
