###########
#        \#
#         #
#         #
#         #
#         #
#\\\  R   #
#########L#

Water 2
Flooding 10 
Waterproof 6
